8 1
@#@@@@%@
@ @ @@ @
@ @    @
@   *  @
@@@@  @@
@ @@  @@
@     @@
@@@@@@@@
