8 2
@#@@@@%@
@ @ @@ @
@ @    @
@   *  @
@@@   @@
@  *  @@
@      %
@@@@@@@@
