5
11111
12001
10301
10041
11111