0111111
11000011
10330001
10102221
10001031
11111111
#4530
1111110
1304011
1200201
1000101
1003001
1111111
#1231
111111
100331
1012011
1010001
1002101
1004001
1111111
#1131
11111
10001
1010111
1324001
1001201
1000031
1111111
#5131
0011100
1110001
1304101
1000201
1023011
111111
#1531
1111111
10000011
103240011
101230001
100000001
111111111
#1131
111111
100301
1013011
1003001
1022201
1001001
1111111
#5530
1111
1001111
1000431
1002101
1003201
1111111
#4531
1111111
10030011
10221301
10101001
10031001
11111111
#3330
111111
1000011
1022201
1103331
1000101
1000001
1111111
#1130
1111
1001
10011
100011
1202011
1301201
1003031
1111111
#4430
111111
100031
122201
130101
100301
111111
#2430
1111111
10000011
10101201
13024001
10001031
11111111
#4131
111111
1000011
1001401
1000201
1002331
1111111
#2131
00011111
11110301
10020001
10004401
10000111
111111
#4232
01111110
11003011
10002201
10130201
10031001
11111111
#2630
1111111
1003001
10201011
13120201
10031001
10001001
11111111
#4530
11111
1300111
1010201
1004001
1001101
1040001
1111111
#5532
1111111
10000011
10101001
13222301
10001301
11111111
#2330
1111
1031111
1220001
1320101
1003001
1111111
#1130
111111111
100010001
100020001
110121011
11010301
13343421
10021001
11100001
00111111
#546