#### 
#@ # 
# O##
##  #
#.  #
#####

######
#   @#
##OO #
#.  .#
######

#######
#. O .#
#  O ##
#. O @#
#######

 ####
 #  #
##O.#
#   #
# # #
#.O@#
#   #
#####

  ######
###.@  #
#  OQO #
#   . ##
####### 

######
#@ =.#
# OOQ#
# = .#
######

  #####
###=  #
#   QQ#
# O#..#
# =O ##
# @  # 
###### 

#######
#. . .#
# OOO #
#.O@O.#
# OOO #
#. . .#
#######
