8
@ @@@@#@
@ @ @@ @
@ @ @  @
@      @
@@@@@ @@
@ @@  @@
@     @@
@@@@@@@@
